- - - - - - - - - - - - - - - - - - - - - - 
- - - - - - - - - W W W W W W W W - - - - - 
- - - - - - - - - W - - - - - - W - - - - - 
- - - - - - - - - W - i - - - - W - - - - - 
- - - - - - - - - W - - - - - - W - - - - - 
- - - - - W W W W W - - - - v - W - - - - - 
- - - - - W - - - - - - - - - - W - - - - - 
- - - - - W - f - - - F - - - - W - - - - - 
- - - - - W - - - - - - - - - - W - - - - - 
- - - - - W W W W W W W W W W W W - - - - - 
- - - - - - - - - W - - - - - - W - - - - - 
- - - - - - b - - W - w - - - - W - - - - - 
- - - - - - i - - W - i - - B - W - - - - - 
- - - - - - y - - W - t - - - - W - - - - - 
- - - - - - - - - W - - - - - - W - - - - - 
- - - - - - - - - W W W W W W W W - - - - - 
- - - - - - - - - - - - - - - - - - - - - - 
- - - - - - - - - - - - - - - - - - - - - - 