_B_GGG_WlWwip___L
G__ggg_WiW_S__sik
Gr_W_SW_nW___SSSS
GiS__SLW_WS______
Gu_W__WWWSRRRRS__
_____WWWSS_______
_SSSS__W____SSSRS
___R____W________
___biyS_WWWRWWWW_
________W________
____________RRR__
