rip_R_______S___________
____R_____WWSWWWWWWW____
sid_R_____W_S__W___W____
____R_____W_S____F_W____
fin_R_WWWWW_S__W___W____
____R_W___W_S__WWWWW____
RRRRR_W_B___SWWW________
______W___W_SSSSSSSSSSSS
______WWWWW____W________
__________W_wipW________
________b_W____W________
________i_WWWWWW________
________y_______________