- B - G G G - W l W w i p - - - L 
G - - g g g - W i W - S - - s i k
G r - W - S W - v W - - - S S S S 
G i S - - S L W - W S - - - - - - 
G p - W - - W W W S R R R R S - - 
- - - - - W W W S S - - - - - - - 
- S S S S - - W - - - - S S S R S 
- - - R - - - - W - - - - - - - - 
- - - b i y S - W W W R W W W W - 
- - - - - - - - W - - - - - - - - 
- - - - - - - - - - - - R R R - - 
	