- - - - - - - - - - - - - - - - - - - - - - - - - - - - - - - - -
- - - - - - - - - - - - - - - - - - - - - - - - - - - - - - - - -
- - - - - - - - - - - - - - - - - - - - - - - - - - - - - - - - -
- - - - b i y - - - - - - - - - - - - - - - - f i v - - - - - - -
- - - - - - - - - - - - - - - - - - - - - - - - - - - - - - - - -
- - - - W W W W W W W W W W W W W - - - - - - - - - - - - - - - -
- - - - - - - - - - - - - - R - - - - - - - - - - - - - - - - - -
- - - B - - - - - - - - - - R - - - - - - - F - - - - - - - - - -
- - - - - - - - - - - - - - R - - - - - - - - - - - - - - - - - -
- - - - W W W W W W W W W W W W W - - - - - - - - - - - - - - - -
- - - - - - - - - - - - - - - - - - - - - - - - - - - - - - - - -
- - - - r i p - - - - - - - - - - - - - - - - w i t - - - - - - -
- - - - - - - - - - - - - - - - - - - - - - - - - - - - - - - - -
- - - - - - - - - - - - - - - - - - - - - - - - - - - - - - - - -
- - - - - - - - - - - - - - - - - - - - - - - - - - - - - - - - -